1 0 1 1 1 1 1 1 1 7 0 0 0 0 0 0 0 0 1 7 1 0 1 0 0 0 0 0 7 1 
1 0 1 0 0 3 0 0 1 7 1 0 1 0 0 0 0 0 1 7 1 0 1 0 0 5 5 0 7 1 
1 0 0 0 0 0 0 0 0 0 0 0 0 0 0 1 0 0 0 0 0 3 0 0 0 5 5 0 1 1 
1 0 1 0 0 2 0 0 1 7 1 0 1 0 0 0 0 0 1 7 1 0 1 0 0 0 0 1 0 1 
1 0 1 0 0 0 0 0 0 0 0 0 1 0 0 0 5 0 6 0 1 0 1 0 0 0 0 0 0 1 
0 0 1 0 3 0 3 0 1 7 1 0 1 0 0 3 0 0 1 7 1 0 1 0 0 1 0 0 3 1 
0 0 0 0 0 0 0 0 0 0 0 0 0 0 0 0 0 0 0 0 0 0 0 0 0 0 0 0 0 1 
1 0 1 0 0 7 0 0 1 0 1 0 1 0 0 0 0 0 1 7 1 0 1 0 0 0 0 1 0 1 
0 0 0 0 0 0 0 0 0 0 1 0 1 0 3 0 0 0 1 0 1 0 1 0 0 0 0 0 0 1 
1 0 1 0 3 0 3 0 1 7 5 0 1 0 0 0 0 0 1 7 1 0 1 0 0 1 0 0 1 7 
0 0 0 0 0 0 0 0 0 0 0 0 0 0 0 0 1 0 0 0 0 0 0 0 0 0 0 0 0 7 
0 0 0 0 0 0 0 0 0 0 0 0 0 0 0 7 0 0 0 0 0 0 0 3 0 0 1 0 0 7  
0 0 1 0 0 0 0 0 1 7 1 0 1 0 0 0 9 9 9 9 9 9 1 0 0 0 0 0 0 0 
1 0 0 0 1 0 0 0 1 7 1 0 1 0 0 0 9 3 1 7 1 9 1 0 0 0 0 0 3 7 
0 0 0 0 0 0 0 0 0 0 0 0 0 0 3 0 9 3 3 3 3 9 0 0 3 0 1 0 0 0 
0 0 0 0 0 0 3 0 0 0 0 0 0 0 0 0 9 3 3 3 3 9 0 0 0 0 0 0 0 7 
1 0 1 0 0 0 0 0 1 7 1 0 1 0 0 0 9 9 9 6 9 9 1 0 0 0 0 0 0 1 
0 0 0 0 0 0 0 0 0 0 0 0 0 0 0 3 0 0 0 0 0 0 0 0 7 1 0 0 1 1 
0 0 0 0 0 1 0 0 0 0 0 0 0 1 0 0 0 0 3 0 1 0 0 0 0 0 0 0 1 1 
0 0 0 0 0 0 0 0 0 0 4 0 0 0 0 0 6 0 0 0 0 0 0 0 7 0 0 0 1 1 
0 0 0 0 0 0 3 0 0 0 0 0 0 5 0 0 0 0 0 0 0 0 0 0 0 0 0 0 1 1 
1 0 0 0 0 0 0 0 1 7 1 0 1 0 0 0 1 0 1 7 1 0 1 0 0 0 0 0 1 1 
1 0 0 0 0 0 0 0 0 7 1 3 1 0 0 0 0 5 1 7 0 0 1 0 0 3 0 0 0 1 
1 0 5 0 1 0 0 0 1 7 1 0 0 0 0 0 0 0 1 7 1 0 1 0 0 0 0 0 7 1 
0 0 1 0 0 0 0 0 1 0 1 0 7 0 0 7 1 0 1 7 1 0 1 0 3 0 7 0 1 1 
0 0 0 0 0 0 0 0 0 7 1 0 0 0 0 3 0 0 0 7 0 0 0 0 0 0 0 0 7 1 
0 0 1 0 0 3 0 3 0 3 1 0 0 0 0 0 0 0 1 7 1 0 1 0 3 6 0 0 1 1 
1 0 0 0 0 0 0 0 0 7 1 5 0 3 0 0 0 3 1 7 1 0 1 0 0 0 0 0 7 1 
1 0 1 0 0 0 0 0 1 0 1 0 0 0 0 7 1 0 1 7 1 0 1 0 0 3 0 0 7 1 
1 0 1 0 0 0 0 0 1 0 1 0 0 0 1 0 0 0 1 7 1 0 1 0 0 0 0 0 1 1 